bölcsesség=print
ajtóKinyit=import
beenged=from
cisco=os
packettracer=system

haha=if
haha'nt=else
hahaIsNem=elif

OWO nyit komment=#
UWU nyit komment="""
UWU comment záring="""

irniFuzetbe=while
nyit=for
nézzKörül=range
töröl=remove

dolgozat=input
kerekség=int
lebegniFogsz=float
straight=str
formálódás=f

hihiAzLeszAz=True
hohoNemAzLeszAz=False

hozdÖssze=+
válaszdSzét=-
jóóóSokszor=*
kabbe=/
maradsz=%
hatvankodik=**

orr=or
pénzeső=not
ilyenFiatalon=and
egyesüljünk==
legyenEgyesülés===
húúDeNagy=>
húúDeNagyVagyMégsem=>=
nemAMéretSzámít=<
kicsiDeMégsem=<=
nekemNagyobb=!=
pontosulás=:
törődj bele=break

listaNyit=[
listaZáradék=]
buborék=.pop
töröldKi=.remove
brüsszeliGurulóDollárok=.append
jóóHosszú=len
függöny=def
hozdVissza=return